||||||||||||||||||||||||||||||
|............................|
|..||||.||.||||||||.||.||||..|
|..||||.||.||||||||.||.||||..|
|..||||......||||......||||..|
|..||||.||||..||..||||.||||..|
|.......|||||.||.|||||.......|
|..||||.|||||....|||||.||||..|
|..||||.|||||.||.|||||.||||..|
|..||||.|||||.||.|||||.||||..|
|..........||.||.||..........|
|..|||.|||..........|||.|||..|
|..|||.|||.||....||.|||.|||..|
|..|||.....|......|.....|||..|
|..|||.|||.|......|.|||.|||..|
|..|||.|||.|......|.|||.|||..|
|..........||....||..........|
|..||||.||..........||.||||..|
|..||||.||||.||||.||||.||||..|
|.........||.||||.||.........|
|..|||.||.||......||.||.|||..|
|..|||.||.....||.....||.|||..|
|.......||.||.||.||.||.......|
|..||||.||.||.||.||.||.||||..|
|..||||................||||..|
|.......||.||||||||.||.......|
|..||||.||.||||||||.||.||||..|
|..||||.||.||||||||.||.||||..|
|............................|
||||||||||||||||||||||||||||||
